| ru | eng | gr | ba | tr |

# Алфавит
## Согласные

### Звонкие
β, γ, δ, ζ, λ, ρ, μ, ν
### Глухие
κ, π, τ, χ, φ, θ, σ, ψ, ξ

## Главние
α, ε, η, ι, ο, υ, ω

# Слова

да - Ναί (наи)
нет - Οχι (охиq)

стол - table - Τραπέζι (трапе'зи) - өсәл - masa
стул - chair - καρέκλα (каре'кла) - ултырғыс - sandalye
дверь - door - θύρα (thira) - ишек - kapı
картина - painting - ζωγραφική (зографити) - картинаһы - tablo
книга - book - Βιβλίο (вивли'о) - китап - kitap
карандаш - pencil - μολύβι (моли'би) - ҡәләм - kalem
ручка - pen - στυλό (стило') - ҡәләм - dolma kalem

чашка - cup - φλιτζάνι (флитза'ни) - ҡасә - bardak
кружка - mug - κούπα (ку'па) - түңәрәк - saldırıp soymak
еда - food - τροφή (трофи') - ашамдыҡ - yiyecek
вода - water - νερό (неро') - һыу - su
чай - tea - τσάι (тса'и) - сәй - çay

Отец - - πατεπας (патэпас)
Папа - - μπαμπας (бамбас)

мать - - μητερα (матера)
Мама - - μαμα (мама)

брат - - αδελφος (адэлфос)
сестра - - αδελφη (адэлфи)

завтрак - - προωιυο (про)

Друг - - φιλε (филэ')
Знаю - - ξέρω (ксе'ро)

машина
дом - σπίτι (спити)
квартира - διαμέρισμα (деамэрисма)

год - έτος
лет - χρόνια

# Вопросы

как ты - Πώς είσαι
сколько тебе лет - Πόσο χρονών είσαι

сколько - Πόσα
чья - του οποίου
кому -  σε ποιον


Как - - πως (пос)
где - - Οπου (опу)
почему  - Γιατί (гяти)
зачем  - Για τι (гя ти)

# Местоимения

Я - I - Εγώ (его) - мен - ben
Ты - You - εσύ (эси) - һең - sen

Он - He - αυτός (афтос) - ул - o
Она - αυτή (афти) - 
Оно - το (то) - 

Мы - We - εμείς (эмис) - быҙ - biz
Вы - You - εσείς (эсис) һығыҙ - 
Они - Τhey - αυτοί (афти) - улар - onlar

# Приветствия

Привет - Hi - γεια (г`иа) - Сәләм - merhaba
Здравствуйте - Hello -  Γειά σου (г`иа су) - Һаумыһығыҙ - merhaba
Пока - Bye - αντίο (ант`ио) - һуш - hoşçakal
Доброе утро - Καλημέρα (калимэ'´ра)

# Числа

один - one - ένας (энас) -  - bir
два - two - δύο (дзи'о) - - iki
три - three - τρία (три'а) - - üç
четыри - four - τέσσερις (тэ'сэрис) - - dört
пять - five - πέντε (пенте) - - beş
шесть - six - έξι (эхси) - - altı
семь - seven - επτά (эпта') - - yedi
восемь - eight - οκτώ (окто') - - sekiz
девять - nine - εννέα (эннэ'а) - - dokuz
десять - ten - δέκα (дзэ'ка) - - on

одиннадцать - έντεκα
двенадцать - δώδεκα
тринадцать - δεκατρείς
четырнадцать - δεκατέσσερα
пятнадцать - δεκαπέντε
щестнадцать - δεκαέξι
семнадцать - δεκαεπτά
восемнадцать - δεκαοχτώ
девятнадцать - δεκαεννέα
двадцать - είκοσι

# Математика

плюс - συν
минус - μείον
равно - ισοδυναμεί
умножить - πολλαπλασιάζω
по делить - διαιρέστε με

# Буквосочетания (только греческий)

αι [э]
ει [и]
οι [и]
ου [у]

αυ [ав] - если после Буквосочетания идёт звонкая или гласная
αυ [аф] - если после Буквосочетания идёт глухия

ευ [эв] - если после Буквосочетания идёт звонкая или гласная
ευ [эф] - если после Буквосочетания идёт глухия

τσ [ц]
τζ [дз]
γγ [нг]

γχ [нх] 

γκ [г] - в начале слова
γκ [нг] - в середине слова

υτ [д] - в начале слова
υτ [нд] - середине слова

μπ [бсрк] - в начале слова
μπ [мб] - в середине слова

για
γεια   [я]

γιο
γιω    [ё]

γιου [ю]
